┏━━━━━━━━━━━━┓┏━━━━━━━━━━━━┓
┃............┃┃............┃
┃.┏━━┓.┏━━━┓.┃┃.┏━━━┓.┏━━┓.┃
┃.┃  ┃.┃   ┃.┃┃.┃   ┃.┃  ┃.┃
┃.┗━━┛.┗━━━┛.┗┛.┗━━━┛.┗━━┛.┃
┃..........................┃
┃.┏━━┓.┏┓.┏━━━━━━┓.┏┓.┏━━┓.┃
┃.┗━━┛.┃┃.┗━━┓┏━━┛.┃┃.┗━━┛.┃
┃......┃┃....┃┃....┃┃......┃
┗━━━━┓.┃┗━━┓.┃┃.┏━━┛┃.┏━━━━┛
     ┃.┃┏━━┛.┗┛.┗━━┓┃.┃
     ┃.┃┃..........┃┃.┃
     ┃.┃┃.┏━╸  ╺━┓.┃┃.┃
━━━━━┛.┗┛.┃      ┃.┗┛.┗━━━━━
      ....┃      ┃....
━━━━━┓.┏┓.┃      ┃.┏┓.┏━━━━━
     ┃.┃┃.┗━━━━━━┛.┃┃.┃
     ┃.┃┃..........┃┃.┃
     ┃.┃┗━━┓.┏┓.┏━━┛┃.┃
┏━━━━┛.┃┏━━┛.┃┃.┗━━┓┃.┗━━━━┓
┃......┃┃....┃┃....┃┃......┃
┃.┏━━┓.┃┃.┏━━┛┗━━┓.┃┃.┏━━┓.┃
┃.┗━━┛.┗┛.┗━━━━━━┛.┗┛.┗━━┛.┃
┃..........................┃
┃.┏━━┓.┏━━━┓.┏┓.┏━━━┓.┏━━┓.┃
┃.┃  ┃.┃   ┃.┃┃.┃   ┃.┃  ┃.┃
┃.┗━━┛.┗━━━┛.┃┃.┗━━━┛.┗━━┛.┃
┃............┃┃............┃
┗━━━━━━━━━━━━┛┗━━━━━━━━━━━━┛