┏━━━━━━━━━━━━━━━━━━━━━━━┓
┃                       ┃
┃                       ┃
┃                       ┃
┃      ┃   B            ┃
┃      ┃      G         ┃
┃                       ┃
┃                       ┃
┃                       ┃
┃                       ┃
┃    B                  ┃
┃                       ┃
┃                       ┃
┃                       ┃
┗━━━━━━━━━━━━━━━━━━━━━━━┛